REB = "countries/rebels.txt"
ENG = "countries/ENG.txt"
RUS = "countries/RUS.txt"
FRA = "countries/FRA.txt"
PRU = "countries/PRU.txt"
GER = "countries/GER.txt"
AUS = "countries/AUS.txt"
USA = "countries/USA.txt"
JAP = "countries/JAP.txt"
ITA = "countries/ITA.txt"
KUK = "countries/Austria-Hungary.txt"
DEN = "countries/DEN.txt"
FIN = "countries/FIN.txt"
NOR = "countries/NOR.txt"
SCA = "countries/SCA.txt"
SWE = "countries/SWE.txt"
BEL = "countries/BEL.txt"
CAT = "countries/CAT.txt"
FLA = "countries/FLA.txt"
IRE = "countries/IRE.txt"
NET = "countries/NET.txt"
POR = "countries/POR.txt"
SCO = "countries/SCO.txt"
SPA = "countries/SPA.txt"
WLL = "countries/WLL.txt"
ANH = "countries/ANH.txt"
BAD = "countries/BAD.txt"
BAV = "countries/BAV.txt"
BRA = "countries/BRA.txt"
BRE = "countries/BRE.txt"
COB = "countries/COB.txt"
DZG = "countries/DZG.txt"
FRM = "countries/FRM.txt"
HAM = "countries/HAM.txt"
HAN = "countries/HAN.txt"
HES = "countries/HES.txt"
HEK = "countries/Hesse-Kassel.txt"
HOL = "countries/HOL.txt"
LIP = "countries/Lippe-Detmold.txt"
LUB = "countries/LUB.txt"
LUX = "countries/LUX.txt"
MEC = "countries/MEC.txt"
MEI = "countries/MEI.txt"
NAS = "countries/NAS.txt"
NGF = "countries/NGF.txt"
OLD = "countries/OLD.txt"
SAX = "countries/SAX.txt"
SCH = "countries/Schleswig.txt"
SGF = "countries/South German Fed.txt"
WEI = "countries/WEI.txt"
WUR = "countries/WUR.txt"
LOM = "countries/LOM.txt"
LUC = "countries/Lucca.txt"
MOD = "countries/MOD.txt"
PAP = "countries/PAP.txt"
PAR = "countries/PAR.txt"
SAR = "countries/SAR.txt"
SIC = "countries/SIC.txt"
TRE = "countries/Trieste.txt"
TUS = "countries/TUS.txt"
VEN = "countries/VEN.txt"
BOH = "countries/BOH.txt"
KRA = "countries/KRA.txt"
CRI = "countries/CRI.txt"
EST = "countries/Estonia.txt"
HUN = "countries/HUN.txt"
LIT = "countries/LIT.txt"
LAT = "countries/LAT.txt"
POL = "countries/POL.txt"
SLV = "countries/Slovakia.txt"
SWI = "countries/SWI.txt"
RUT = "countries/Ruthenia.txt"
SIE = "countries/SIE.txt"
UKR = "countries/UKR.txt"
CZH = "countries/Czechoslovakia.txt"
ALB = "countries/ALB.txt"
BOS = "countries/BOS.txt"
BUL = "countries/BUL.txt"
CRE = "countries/CRE.txt"
CRO = "countries/CRO.txt"
CYP = "countries/CYP.txt"
GRE = "countries/GRE.txt"
ION = "countries/ION.txt"
MOL = "countries/MOL.txt"
MON = "countries/MON.txt"
ROM = "countries/ROM.txt"
SER = "countries/SER.txt"
SLO = "countries/Slovenia.txt"
TUR = "countries/TUR.txt"
WAL = "countries/WAL.txt"
YUG = "countries/Yugoslavia.txt"
ALD = "countries/ALD.txt"
CNG = "countries/CNG.txt"
EGY = "countries/EGY.txt"
ETH = "countries/ETH.txt"
MAD = "countries/Madagascar.txt"
LIB = "countries/LIB.txt"
MOR = "countries/MOR.txt"
NAL = "countries/Natalia.txt"
ORA = "countries/Oranje.txt"
SAF = "countries/South Africa.txt"
SOK = "countries/SOK.txt"
RHO = "countries/RHO.txt"
TRI = "countries/TRI.txt"
TRN = "countries/Transvaal.txt"
TUN = "countries/TUN.txt"
ZAN = "countries/ZAN.txt"
ZUL = "countries/Zulu.txt"
ABU = "countries/ABU.txt"
AFG = "countries/AFG.txt"
ARM = "countries/ARM.txt"
AZB = "countries/Azerbaijan.txt"
BUK = "countries/BUK.txt"
GEO = "countries/GEO.txt"
HDJ = "countries/HDJ.txt"
IRQ = "countries/IRQ.txt"
KHI = "countries/KHI.txt"
KOK = "countries/KOK.txt"
MUG = "countries/MUG.txt"
NEJ = "countries/NEJ.txt"
OMA = "countries/OMA.txt"
PER = "countries/PER.txt"
YEM = "countries/YEM.txt"
HND = "countries/India.txt"
AWA = "countries/AWA.txt"
BAS = "countries/BAS.txt"
BER = "countries/BER.txt"
BHO = "countries/Bhopal.txt"
BIK = "countries/Bikaner.txt"
BUN = "countries/BUN.txt"
GWA = "countries/GWA.txt"
HYD = "countries/HYD.txt"
IND = "countries/IND.txt"
JAI = "countries/Jaipur.txt"
JAS = "countries/Jaisalmer.txt"
JOD = "countries/JOD.txt"
KAL = "countries/KAL.txt"
KAS = "countries/Kashmir.txt"
KUT = "countries/KUT.txt"
LAD = "countries/Ladakh.txt"
MAK = "countries/MAK.txt"
MEW = "countries/Mewar.txt"
MYS = "countries/MYS.txt"
NAG = "countries/NAG.txt"
NEP = "countries/NEP.txt"
ORI = "countries/ORI.txt"
PAN = "countries/PAN.txt"
SHI = "countries/Shimla.txt"
SIK = "countries/Sikkim.txt"
SIN = "countries/SIN.txt"
TRA = "countries/TRA.txt"
ATJ = "countries/ATJ.txt"
BAL = "countries/BAL.txt"
BHU = "countries/BHU.txt"
BRU = "countries/BRU.txt"
BUR = "countries/BUR.txt"
CAM = "countries/CAM.txt"
CHI = "countries/CHI.txt"
DAI = "countries/DAI.txt"
JAV = "countries/JAV.txt"
KOR = "countries/KOR.txt"
LUA = "countries/LUA.txt"
JOH = "countries/JOH.txt"
SIA = "countries/SIA.txt"
TIB = "countries/TIB.txt"
MGL = "countries/MGL.txt"
WIA = "countries/Wiang Chhan.txt"
PHI = "countries/PHI.txt"
MCK = "countries/MCK.txt"
GXI = "countries/Guangxi Clique.txt"
SXI = "countries/SXI.txt"
YNN = "countries/Yunnan.txt"
XBI = "countries/Xibei San Ma.txt"
XIN = "countries/XIN.txt"
CAL = "countries/CAL.txt"
CAN = "countries/CAN.txt"
CHE = "countries/CHE.txt"
COL = "countries/Columbia.txt"
COS = "countries/Costa Rica.txt"
CSA = "countries/CSA.txt"
CUB = "countries/Cuba.txt"
DES = "countries/Deseret.txt"
DOM = "countries/Dominican Republic.txt"
ELS = "countries/El Salvador.txt"
GUA = "countries/GUA.txt"
HAI = "countries/HAI.txt"
HAW = "countries/Hawaii.txt"
MAN = "countries/Manhattan Commune.txt"
MEX = "countries/MEX.txt"
MTC = "countries/Metis Confederacy.txt"
HON = "countries/Honduras.txt"
NEN = "countries/New England.txt"
NEW = "countries/Newfoundland.txt"
NIC = "countries/Nicaragua.txt"
PNM = "countries/Panama.txt"
QUE = "countries/QUE.txt"
TEX = "countries/Texas.txt"
UCA = "countries/UCA.txt"
ARG = "countries/ARG.txt"
BOL = "countries/BOL.txt"
BRZ = "countries/BRZ.txt"
CHL = "countries/CHL.txt"
CLM = "countries/CLM.txt"
ECU = "countries/ECU.txt"
PEU = "countries/PEU.txt"
PRG = "countries/PRG.txt"
URU = "countries/Uruguay.txt"
VNZ = "countries/VNZ.txt"
AST = "countries/Australia.txt"
NZL = "countries/New Zealand.txt"
ISR = "countries/ISR.txt"
BYZ = "countries/BYZ.txt"
ICL = "countries/Iceland.txt"
BAB = "countries/Babylonia.txt"
